00 01 02 03 04 05 06 07
08 09 10 11 12 13 14 15
16 17 18 19 20 21 22 23
24 25 26 27 28 29 30 31
32 33 34 35 36 37 38 39
40 41 42 43 af 8d 04 08     /* 45 ~ 48 跳转 */
48 49 50 51 ef b4 da 17     /* 52 ~ 55 cookie */
56 57 58 59 60 61 62 63